1111111111111111
111111
111111
1111
11
1
1
111
1111