111111111
1P0100C01
100C01111
111C00011
1E0010001
1110C0001
111111111