11111111
1E00C001
110000C1
11P00001
11111111
