1111111111111
11E0001101111
1111001010001
110C011011111
110C011000001
110C011000001
1111111000001
1111111111111
