11111111
1EC00111
1C1101P1
11000111
11111111
