11111111
1PC00001
1C110001
11000011
11111111
