111111111111
1E1000000001
100000000001
1000000000P1
110000000001
1C0000000001
111111111111
