11111111111111111111111
10C0000Z0000000000C0001
101110C1111011110111101
101E1000001000C10100101
10001Z00001000010100101
10001C0111101111Z000101
1C0010000010CCC1CCCC101
100010000C1000010000101
10011101111011110000101
1P00CCCCCCCCCCCCCCCCZC1
11111111111111111111111