11111111111111111111111
10C000000000000000C0001
101110C1111011110111101
101E1000001000C10100101
10001000001000010100101
10001C01111011110000101
1C0010000010C0010000101
100010000C1000010000101
10011101111011110000101
1P000000000C000000000C1
11111111111111111111111