111111111
1C0100C01
1P0000111
111000011
1E0010001
1111Z0001
111111111