11111111111111111111111111
1Z0000000000Z0000000001CE1
10000Z00000000Z0000000CC11
100000000000000000Z0000001
100Z00Z0000000000000000001
1000000000000000000000Z001
1Z00000000000Z0000000Z0001
100000Z0000000000000000001
100000000000000Z0000000001
1P00000Z0000000000Z00000Z1
11111111111111111111111111