1111111111111111111111
1C10001011101110100011
1010101111111111101C11
1000000P00000000001111
1011101011101010111011
11111110111C1010001011
1000111011111010111011
1010101011111110101011
1110111010001010111011
1000C00C101010000000E1
1111111111111111111111