1111111111111111111111111111
1E0010C0000000000001CC100001
1000111000000000000100100001
1P00000000000000000000000001
1000000000000000000001000001
100C00000000000000000100CCC1
1111111111111111111111111111