1111111111111
1P0000C0000C1
1E101010101C1
1010000C00001
1C10101C10101
10000C00000C1
1010101010101
1C0000C000C01
101C101010101
1C000000000C1
101C101010101
1C000000000C1
1111111111111