11111111
1C1E0C11
10111001
10000C01
1P1C0101
11111111