111111111111111
1C0C1C0C1C0C1E1
101010101010101
101010101010101
101010101010101
101010101010101
1P1C0C1C0C1C0C1
111111111111111