1111111111
1P00C00001
10000E001
1111111111