1111111
10001C1
1E00001

10000P1
1111111