1111111111
1000000001
1PCE000001
1MMMMMMMM1
1111111111