111111111
1000C0001
100000001
111011111